NO ./path_to_the_north_texture
SO ./path_to_the_south_texture
WE ./path_to_the_west_texture
EA ./path_to_the_east_texture

F 220,100,0
C 225,30,0
         1
       1101
   1111000011
   11100000001
   10001111111111111 111111
    111
